NO ./assets/north.xpm
SO ./assets/south.xpm
WE ./assets/west.xpm
EA ./assets/east.xpm
C 222,0,10
F 220,100,0

0000000000001111   dsdsd  11100000000000000000000000000000000000000000000000000001
0011111111111111111111111111111111111111111111111111111111111111111111111111111110
1110000000000000000000000000000000000000000000000000011110000000000000000000000001
110000000000000111d111111111d11111000111111111111100011111100000000000000000000000
100000000000000111d111111111d11111000011111111111100011111111111111111111111111001
1001111111111111111111111111111111000000111111111100011111111111111000000000000000
100111111111111111dd1111111dd11111010110001111111100011111111111111111111111111111
10011111111110001111ddddddd1000111000111000111111100011110001111101111111111111110
1000000011111000111111111111000111000111100011111100011110001111011  11 1 11 10111
1000000011111000111111111111000111000111110001111100011110001110111111111111111110
1001111111111000111111111111000111000111111000111100011110001101111
1001111111111000111111111111000111000111111100011100011110001011111011111111111111
1001111111111000111111111111000111000111111110001100011110000111111111111111111111
1001111111111000111111111111000111000111111111000100011110001011111110111111111111
100111111111110001111111111100011100011s1111s1100000011110001101111111111111111111
10011111111111100001111110000111110d01s111111s110000011110001110111111111111111110
10011111111111111100000000111111110s01ss111ss1111000011110001111011111111111111111
1011111111111111111111111111111111000111sss111111100011111111111111111111111111110
10000000000000000000000000000000000S000000000000000000000000000000000000000000011
11111111111111111111111111111111111111111111111111111111111111111111111111111111101
