//	this is to be ignored but allow for comments

NO		../assets/north.xpm
SO ../assets/south.xpm
F 220,100,0
  WE	../assets/west.xpm
	 	EA ../assets/east.xpm
C		 225,0,10

000000000000111111111111111110000000000000000000000000000000000000000000000000000
001111111111111111111111111111111111111111111111111111111111111111111111111111111
111000000000000000000000000000000000000000000000000001111000000000000000000000000
110000000000000111111111111111111100011111111111110001111110000000000000000000000
100000000000000111111111111111111100001111111111110001111111111111111111111111100
100111111111111111111111111111111100000011111111110001111111111111100000000000000
100111111111111111111111111111111100011000111111110001111111111111111111111111111
100111111111100011111111111100011100011100011111110001111000111110111111111111111
100000001111100011111111111100011100011110001111110001111000111101111111111111111
100000001111100011111111111100011100011111000111110001111000111011111111111111111
100111111111100011111111111100011100011111100011110001111000110111111111111111111
100111111111100011111111111100011100011111110001110001111000101111111111111111111
100111111111100011111111111100011100011111111000110001111000011111111111111111111
100111111111100011111111111100011100011111111100010001111000101111111111111111111
100111111111110001111111111100011100011111111110000001111000110111111111111111111
100111111111111000011111100001111100011111111111000001111000111011111111111111111
100111111111111111000000001111111100011111111111100001111000111101111111111111111
101111111111111111111111111111111100011111111111110001111111111111111111111111111
10000000000000000000000000000000000S00000000000000000000000000000000000000000001
111111111111111111111111111111111111111111111111111111111111111111111111111111111
