WE ./assets/green.xpm
EA ./assets/blue.xpm


NO ./assets/red.xpm
					
					
					
SO ./assets/grey.xpm


F 153                                   ,204		,255
C 128,128,			128

111111111111                           11111111111111111 
10000000011                            10000000000000001
101100000111                           1E100001100000101
100100000001                           10100000110000101
100000000001                           10000000000000001
111111111111                           1111111111111011111111111111111111111111111
11111111111111111111111111111111111111111111111110000000000000000000000000000001111111111111111111111111111111111111111111111111 
11111111111111111111111111111111111111111111000000000000000000000000000000000000000011111111111111111111111111111111111111111111 
11111111111111111111111111111111111111111000000000000000000000000000000000000000000000011111111111111111111111111111111111111111 
11111111111111111111111111111111111111000000000000000000000000000000000000000000000000000011111111111111111111111111111111111111 
11111111111111111111111111111111111000000000000000000000000000000000000000000000000000000000011111111111111111111111111111111111 
11111111111111111111111111111111100000000000000000000000000000000000000000000000000000000000000111111111111111111111111111111111 
11111111111111111111111111111110000000000000000000000000000000000000000000000000000000000000000001111111111111111111111111111111 
11111111111111111111111111111100000000000000000000000000000000000000000000000000000000000000000000111111111111111111111111111111 
11111111111111111111111111110000000000000000000000000000000000000000000000000000000000000000000000001111111111111111111111111111 
11111111111111111111111111100000000000000000000000000000000000000000000000000000000000000000000000000111111111111111111111111111 
11111111111111111111111110000000000000000000000000000000000000000000000000000000000000000000000000000001111111111111111111111111 
11111111111111111111111100000000000000000000000000000000000000000000000000000000000000000000000000000000111111111111111111111111 
11111111111111111111111000000000000000000000000000000000000000000000000000000000000000000000000000000000011111111111111111111111 
11111111111111111111110000000000000000000000000000000000000000000000000000000000000000000000000000000000001111111111111111111111 
11111111111111111111100000000000000000000000000000000000000000000000000000000000000000000000000000000000000111111111111111111111 
11111111111111111111000000000000000000000000000000000000000000000000000000000000000000000000000000000000000011111111111111111111 
11111111111111111110000000000000000000000000000000000000000000000000000000000000000000000000000000000000000001111111111111111111 
11111111111111111100000000000000000000000000000000000000000111111111100000000000000000000000000000000000000000111111111111111111 
11111111111111111000000000000000000000000000000000000000111111111111111100000000000000000000000000000000000000011111111111111111 
11111111111111110000000000000000000000000000000000000111111111111111111111100000000000000000000000000000000000001111111111111111 
11111111111111100000000000000000000000000000000000111111111111111111111111111100000000000000000000000000000000000111111111111111 
11111111111111000000000000000000000000000000000011111111111111111111111111111111000000000000000000000000000000000011111111111111 
11111111111111000000000000000000000000000000001111111111111111111111111111111111110000000000000000000000000000000011111111111111 
11111111111110000000000000000000000000000000011111111111111111111111111111111111111000000000000000000000000000000001111111111111 
11111111111100000000000000000000000000000001111111111111111111111111111111111111111110000000000000000000000000000000111111111111 
11111111111100000000000000000000000000000011111111111111111111111111111111111111111111000000000000000000000000000000111111111111 
11111111111000000000000000000000000000001111111111111111111111111111111111111111111111110000000000000000000000000000011111111111 
11111111111000000000000000000000000000011111111111111111111111111111111111111111111111111000000000000000000000000000011111111111 
11111111110000000000000000000000000000111111111111111111111111111111111111111111111111111100000000000000000000000000001111111111 
11111111110000000000000000000000000001111111111111111111111111111111111111111111111111111110000000000000000000000000001111111111 
11111111100000000000000000000000000011111111111111111111111111111111111111111111111111111111000000000000000000000000000111111111 
11111111100000000000000000000000000111111111111111111111111111111111111111111111111111111111100000000000000000000000000111111111 
11111111000000000000000000000000001111111111111111111111111111111111111111111111111111111111110000000000000000000000000011111111 
11111111000000000000000000000000011111111111111111111111111111111111111111111111111111111111111000000000000000000000000011111111 
11111111000000000000000000000000111111111111111111111111111111111111111111111111111111111111111100000000000000000000000011111111 
11111110000000000000000000000001111111111111111111111111111111111111111111111111111111111111111110000000000000000000000001111111 
11111110000000000000000000000011111111111111111111111111111111111111111111111111111111111111111111000000000000000000000001111111 
11111110000000000000000000000011111111111111111111111111111111111111111111111111111111111111111111000000000000000000000001111111 
11111100000000000000000000000111111111111111111111111111111111111111111111111111111111111111111111100000000000000000000000111111 
11111100000000000000000000001111111111111111111111111111111111111111111111111111111111111111111111110000000000000000000000111111 
11111100000000000000000000001111111111111111111111111111111111111111111111111111111111111111111111110000000000000000000000111111 
11111100000000000000000000011111111111111111111111111111111111111111111111111111111111111111111111111000000000000000000000111111 
11111100000000000000000000011111111111111111111111111111111111111111111111111111111111111111111111111000000000000000000000111111 
11111100000000000000000000111111111111111111111111111111111111111111111111111111111111111111111111111100000000000000000000111111 
11111000000000000000000000111111111111111111111111111111111111111111111111111111111111111111111111111100000000000000000000011111 
11111000000000000000000001111111111111111111111111111111111111111111111111111111111111111111111111111110000000000000000000011111 
11111000000000000000000001111111111111111111111111111111111111111111111111111111111111111111111111111110000000000000000000011111 
11111000000000000000000011111111111111111111111111111111111111111111111111111111111111111111111111111111000000000000000000011111 
11111000000000000000000011111111111111111111111111111111111111111111111111111111111111111111111111111111000000000000000000011111 
11111000000000000000000011111111111111111111111111111111111111111111111111111111111111111111111111111111000000000000000000011111 
11111000000000000000000111111111111111111111111111111111111111111111111111111111111111111111111111111111100000000000000000011111 
11111000000000000000000111111111111111111111111111111111111111111111111111111111111111111111111111111111100000000000000000011111 
11111000000000000000000111111111111111111111111111111111111111111111111111111111111111111111111111111111100000000000000000011111 
11111000000000000000001111111111111111111111111111111111111111111111111111111111111111111111111111111111110000000000000000011111 
11111000000000000000001111111111111111111111111111111111111111111111111111111111111111111111111111111111110000000000000000011111 
11111000000000000000001111111111111111111111111111111111111111111111111111111111111111111111111111111111110000000000000000011111 
11111000000000000000001111111111111111111111111111111111111111111111111111111111111111111111111111111111110000000000000000011111 
11111000000000000000001111111111111111111111111111111111111111111111111111111111111111111111111111111111110000000000000000011111 
11111000000000000000001111111111111111111111111111111111111111111111111111111111111111111111111111111111110000000000000000011111 
11111000000000000000001111111111111111111111111111111111111111111111111111111111111111111111111111111111110000000000000000011111 
11111000000000000000001111111111111111111111111111111111111111111111111111111111111111111111111111111111110000000000000000011111 
11111000000000000000001111111111111111111111111111111111111111111111111111111111111111111111111111111111110000000000000000011111 
11111000000000000000001111111111111111111111111111111111111111111111111111111111111111111111111111111111110000000000000000011111 
11111000000000000000000111111111111111111111111111111111111111111111111111111111111111111111111111111111100000000000000000011111 
11111000000000000000000111111111111111111111111111111111111111111111111111111111111111111111111111111111100000000000000000011111 
11111000000000000000000111111111111111111111111111111111111111111111111111111111111111111111111111111111100000000000000000011111 
11111000000000000000000011111111111111111111111111111111111111111111111111111111111111111111111111111111000000000000000000011111 
11111000000000000000000011111111111111111111111111111111111111111111111111111111111111111111111111111111000000000000000000011111 
11111000000000000000000011111111111111111111111111111111111111111111111111111111111111111111111111111111000000000000000000011111 
11111000000000000000000001111111111111111111111111111111111111111111111111111111111111111111111111111110000000000000000000011111 
11111000000000000000000001111111111111111111111111111111111111111111111111111111111111111111111111111110000000000000000000011111 
11111000000000000000000000111111111111111111111111111111111111111111111111111111111111111111111111111100000000000000000000011111 
11111100000000000000000000111111111111111111111111111111111111111111111111111111111111111111111111111100000000000000000000111111 
11111100000000000000000000011111111111111111111111111111111111111111111111111111111111111111111111111000000000000000000000111111 
11111100000000000000000000011111111111111111111111111111111111111111111111111111111111111111111111111000000000000000000000111111 
11111100000000000000000000001111111111111111111111111111111111111111111111111111111111111111111111110000000000000000000000111111 
11111100000000000000000000001111111111111111111111111111111111111111111111111111111111111111111111110000000000000000000000111111 
11111100000000000000000000000111111111111111111111111111111111111111111111111111111111111111111111100000000000000000000000111111 
11111110000000000000000000000011111111111111111111111111111111111111111111111111111111111111111111000000000000000000000001111111 
11111110000000000000000000000011111111111111111111111111111111111111111111111111111111111111111111000000000000000000000001111111 
11111110000000000000000000000001111111111111111111111111111111111111111111111111111111111111111110000000000000000000000001111111 
11111111000000000000000000000000111111111111111111111111111111111111111111111111111111111111111100000000000000000000000011111111 
11111111000000000000000000000000011111111111111111111111111111111111111111111111111111111111111000000000000000000000000011111111 
11111111000000000000000000000000001111111111111111111111111111111111111111111111111111111111110000000000000000000000000011111111 
11111111100000000000000000000000000111111111111111111111111111111111111111111111111111111111100000000000000000000000000111111111 
11111111100000000000000000000000000011111111111111111111111111111111111111111111111111111111000000000000000000000000000111111111 
11111111110000000000000000000000000001111111111111111111111111111111111111111111111111111110000000000000000000000000001111111111 
11111111110000000000000000000000000000111111111111111111111111111111111111111111111111111100000000000000000000000000001111111111 
11111111111000000000000000000000000000011111111111111111111111111111111111111111111111111000000000000000000000000000011111111111 
11111111111000000000000000000000000000001111111111111111111111111111111111111111111111110000000000000000000000000000011111111111 
11111111111100000000000000000000000000000011111111111111111111111111111111111111111111000000000000000000000000000000111111111111 
11111111111100000000000000000000000000000001111111111111111111111111111111111111111110000000000000000000000000000000111111111111 
11111111111110000000000000000000000000000000011111111111111111111111111111111111111000000000000000000000000000000001111111111111 
11111111111111000000000000000000000000000000001111111111111111111111111111111111110000000000000000000000000000000011111111111111 
11111111111111000000000000000000000000000000000011111111111111111111111111111111000000000000000000000000000000000011111111111111 
11111111111111100000000000000000000000000000000000111111111111111111111111111100000000000000000000000000000000000111111111111111 
11111111111111110000000000000000000000000000000000000111111111111111111111100000000000000000000000000000000000001111111111111111 
11111111111111111000000000000000000000000000000000000000111111111111111100000000000000000000000000000000000000011111111111111111 
11111111111111111100000000000000000000000000000000000000000111111111100000000000000000000000000000000000000000111111111111111111 
11111111111111111110000000000000000000000000000000000000000000000000000000000000000000000000000000000000000001111111111111111111 
11111111111111111111000000000000000000000000000000000000000000000000000000000000000000000000000000000000000011111111111111111111 
11111111111111111111100000000000000000000000000000000000000000000000000000000000000000000000000000000000000111111111111111111111 
11111111111111111111110000000000000000000000000000000000000000000000000000000000000000000000000000000000001111111111111111111111 
11111111111111111111111000000000000000000000000000000000000000000000000000000000000000000000000000000000011111111111111111111111 
11111111111111111111111100000000000000000000000000000000000000000000000000000000000000000000000000000000111111111111111111111111 
11111111111111111111111110000000000000000000000000000000000000000000000000000000000000000000000000000001111111111111111111111111 
11111111111111111111111111100000000000000000000000000000000000000000000000000000000000000000000000000111111111111111111111111111 
11111111111111111111111111110000000000000000000000000000000000000000000000000000000000000000000000001111111111111111111111111111 
11111111111111111111111111111100000000000000000000000000000000000000000000000000000000000000000000111111111111111111111111111111 
11111111111111111111111111111110000000000000000000000000000000000000000000000000000000000000000001111111111111111111111111111111 
11111111111111111111111111111111100000000000000000000000000000000000000000000000000000000000000111111111111111111111111111111111 
11111111111111111111111111111111111000000000000000000000000000000000000000000000000000000000011111111111111111111111111111111111 
11111111111111111111111111111111111111000000000000000000000000000000000000000000000000000011111111111111111111111111111111111111 
11111111111111111111111111111111111111111000000000000000000000000000000000000000000000011111111111111111111111111111111111111111 
11111111111111111111111111111111111111111111000000000000000000000000000000000000000011111111111111111111111111111111111111111111 
11111111111111111111111111111111111111111111111110000000000000000000000000000001111111111111111111111111111111111111111111111111
1111111111111111111111111111111111111111111111111111111111111111111111111111111111111111111111111111111111111
