

  NO		./assets/tex1.xpm
SO ./assets/tex2.xpm
F 252, 244, 3

  WE	./assets/tex3.xpm

EA ./assets/tex4.xpm

C		 3, 132, 252
  DO	./assets/door.xpm
  XO	./assets/animated_sprite.xpm

1111111111111111111111111111111111111111111111111111111111111111111111111111111111111111111111111111111111111111
1111111111111111111111111111111111111111111111111111111111111111111111111111111111111111111111111111111111111111
1100000000000000000000000000000000000000000000000000000000000000000000000000000000000000000000000000000000000011
1100000000000000000000000000000000000000000000000000000000000000000000000000000000000000000000000000000000000011
1100001111111111111111111111111111000000001111111100001111000011111111000000001111111111111111111111111111000011
1100001111111111111111111111111111000000001111111100001111000011111111000000001111111111111111111111111111000011
1100001111111111111111111111111111000000001111111100001111000011111111000000001111111111111111111111111111000011
1100001111111111111111111111111111000000001111111100001111000011111111000000001111111111111111111111111111000011
1100001111000000000000000000001111000000000000111111111111111111111111000000001111000000000000000000001111000011
1100001111000000000000000000001111000000000000111111111111111111111111000000001111000000000000000000001111000011
1100001111000000000000000000001111000000000000111111111111111111111111000000001111000000000000000000001111000011
1100001111000000000000000000001111000000000000111111111111111111111111000000001111000000000000000000001111000011
1100001111000011111111111100001111000011111111111100000000000000000000000000001111000011111111111100001111000011
1100001111000011111111111100001111000011111111111100000000000000000000000000001111000011111111111100001111000011
1100001111000011111111111100001111000011111111111100000000000000000000000000001111000011111111111100001111000011
1100001111000011111111111100001111000011111111111100000000000000000000000000001111000011111111111100001111000011
1100001111000011111111111100001111000000001111111100000000000011111111000000001111000011111111111100001111000011
1100001111000011111111111100001111000000001111111100000000000011111111000000001111000011111111111100001111000011
1100001111000011111111111100001111000000001111111100000000000011111111000000001111000011111111111100001111000011
1100001111000011111111111100001111000000001111111100000000000011111111000000001111000011111111111100001111000011
1100001111000011111111111100001111000000000000111111110000000000001111000000001111000011111111111100001111000011
1100001111000011111111111100001111000000000000111111110000000000001111000000001111000011111111111100001111000011
1100001111000011111111111100001111000000000000111111110000000000001111000000001111000011111111111100001111000011
1100001111000011111111111100001111000000000000111111110000000000001111000000001111000011111111111100001111000011
1100001111000000000000000000001111000000001111000011110000000011111111000000001111000000000000000000001111000011
1100001111000000000000000000001111000000001111000011110000000011111111000000001111000000000000000000001111000011
1100001111000000000000000000001111000000001111000011110000000011111111000000001111000000000000000000001111000011
1100001111000000000000000000001111000000001111000011110000000011111111000000001111000000000000000000001111000011
1100001111111111111111111111111111000011110000111100001111000011110000111100001111111111111111111111111111000011
1100001111111111111111111111111111000011110000111100001111000011110000111100001111111111111111111111111111000011
1100001111111111111111111111111111000011110000111100001111000011110000111100001111111111111111111111111111000011
1100001111111111111111111111111111000011110000111100001111000011110000111100001111111111111111111111111111000011
1100000000000000000000000000000000000011111111111111111111111100000000111100000000000000000000000000000000000011
1100000000000000000000000000000000000011111111111111111111111100000000111100000000000000000000000000000000000011
1100000000000000000000000000000000000011111111111111111111111100000000111100000000000000000000000000000000000011
1100000000000000000000000000000000000011111111111111111111111100000000111100000000000000000000000000000000000011
1100001111111111110000111111111111111111110000111100000000111111111111111111111111000000000000111100000000000011
1100001111111111110000111111111111111111110000111100000000111111111111111111111111000000000000111100000000000011
1100001111111111110000111111111111111111110000111100000000111111111111111111111111000000000000111100000000000011
1100001111111111110000111111111111111111110000111100000000111111111111111111111111000000000000111100000000000011
1100000000111100001111111100000000111111110000111100001111000000000000000011111111000000000000000000001111000011
1100000000111100001111111100000000111111110000111100001111000000000000000011111111000000000000000000001111000011
1100000000111100001111111100000000111111110000111100001111000000000000000011111111000000000000000000001111000011
11000000001111000011111111000000001111111100001111000011110000000000000000111s1111000000000000000000001111000011
1100000000000000000000111111111111111100001111000000001111111100000000000000000000111111110000111111111111000011
1100000000000000000000111111111111111100001111000000001111111100000000000000000000111111110000111111111111000011
1100000000000000000000111111111111111100001111000000001111111100000000000000000000111111110000111111111111000011
11000000000000000000001111111111111111000011110000000011111111000000s000000000W000111111110000111111111111000011
1100001111111111111111111100000000111111110000000011110000111111111111111111111111000011110000000011110000000011
1100001111111111111111111100000000111111110000000011110000111111111111111111111111000011110000000011110000000011
1100001111111111111111111100000000111111110000000011110000111111111111111111111111000011110000000011110000000011
1100001111111111111111111100000000111111110000000011110000111111111111111111111111000011110000000011110000000011
1100001111000011110000000000001111000000000000000011111111111100001111111111111111000000001111000011111111000011
1100001111000011110000000000001111000000000000000011111111111100001111111111111111000000001111000011111111000011
1100001111000011110000000000001111000000000000000011111111111100001111111111111111000000001111000011111111000011
1100001111000011110000000000001111000000000000000011111111111100001111111111111111000000001111000011111111000011
1100000000000011110000111111110000111111110000000000001111111100000000111111111111000000001111000000001111000011
1100000000000011110000111111110000111111110000000000001111111100000000111111111111000000001111000000001111000011
1100000000000011110000111111110000111111110000000000001111111100000000111111111111000000001111000000001111000011
1100000000000011110000111111110000111111110000000000001111111100000000111111111111000000001111000000001111000011
1100001111000000000000000011111111000011111111000000001111111111110000000011110000111100000000111111111111000011
1100001111000000000000000011111111000011111111000000001111111111110000000011110000111100000000111111111111000011
1100001111000000000000000011111111000011111111000000001111111111110000000011110000111100000000111111111111000011
1100001111000000000000000011111111000011111111000000001111111111110000000011110000111100000000111111111111000011
1100000000111111111111111111110000111100001111000000001111111111111111111100001111000011110000000011110000000011
1100000000111111111111111111110000111100001111000000001111111111111111111100001111000011110000000011110000000011
1100000000111111111111111111110000111100001111000000001111111111111111111100001111000011110000000011110000000011
1100000000111111111111111111110000111100001111000000001111111111111111111100001111000011110000000011110000000011
1100001111000011111111000011111111000011110000000011111111111100000000111111111111111111111111000000000000000011
1100001111000011111111000011111111000011110000000011111111111100000000111111111111111111111111000000000000000011
1100001111000011111111000011111111000011110000000011111111111100000000111111111111111111111111000000000000000011
1100001111000011111111000011111111000011110000000011111111111100000000111111111111111111111111000000000000000011
1100000000000000000000000000000000000011111111000000000000111111110000111100000000000011111111000011111111000011
1100000000000000000000000000000000000011111111000000000000111111110000111100000000000011111111000011111111000011
1100000000000000000000000000000000000011111111000000000000111111110000111100000000000011111111000011111111000011
1100000000000000000000000000000000000011111111000000000000111111110000111100000000000011111111000011111111000011
1100001111111111111111111111111111000011111111000000001111000000001111111100001111000011111111000011111111000011
1100001111111111111111111111111111000011111111000000001111000000001111111100001111000011111111000011111111000011
1100001111111111111111111111111111000011111111000000001111000000001111111100001111000011111111000011111111000011
1100001111111111111111111111111111000011111111000000001111000000001111111100001111000011111111000011111111000011
1100001111000000000000000000001111000011110000000011111111111111110000111100000000000011111111000000000000000011
1100001111000000000000000000001111000011110000000011111111111111110000111100000000000011111111000000000000000011
1100001111000000000000000000001111000011110000000011111111111111110000111100000000000011111111000000000000000011
1100001111000000000000000000001111000011110000000011111111111111110000111100000000000011111111000000000000000011
1100001111000011111111111100001111000011111111111100001111111100000000111111111111111111111111000011110000000011
1100001111000011111111111100001111000011111111111100001111111100000000111111111111111111111111000011110000000011
1100001111000011111111111100001111000011111111111100001111111100000000111111111111111111111111000011110000000011
1100001111000011111111111100001111000011111111111100001111111100000000111111111111111111111111000011110000000011
1100001111000011111111111100001111000000001111000000001111111100001111000000000000111111111111111100000000000011
1100001111000011111111111100001111000000001111000000001111111100001111000000000000111111111111111100000000000011
1100001111000011111111111100001111000000001111000000001111111100001111000000000000111111111111111100000000000011
1100001111000011111111111100001111000000001111000000001111111100001111000000000000111111111111111100000000000011
1100001111000011111111111100001111000011110000000000000000111111110000000000000000000011110000000000001111000011
1100001111000011111111111100001111000011110000000000000000111111110000000000000000000011110000000000001111000011
1100001111000011111111111100001111000011110000000000000000111111110000000000000000000011110000000000001111000011
1100001111000011111111111100001111000011110000000000000000111111110000000000000000000011110000000000001111000011
1100001111000000000000000000001111000011110000000000000000111100001111111111110000000011111111000011110000000011
1100001111000000000000000000001111000011110000000000000000111100001111111111110000000011111111000011110000000011
1100001111000000000000000000001111000011110000000000000000111100001111111111110000000011111111000011110000000011
1100001111000000000000000000001111000011110000000000000000111100001111111111110000000011111111000011110000000011
1100001111111111111111111111111111000011111111000000000000111111111111111111110000111100000000000011111111000011
1100001111111111111111111111111111000011111111000000000000111111111111111111110000111100000000000011111111000011
1100001111111111111111111111111111000011111111000000000000111111111111111111110000111100000000000011111111000011
1100001111111111111111111111111111000011111111000000000000111111111111111111110000111100000000000011111111000011
1100000000000000000000000000000000000000000000000000000000000000000000000000000000000000000000000000000000000011
1100000000000000000000000000000000000000000000000000000000000000000000000000000000000000000000000000000000000011
1111111111111111111111111111111111111111111111111111111111111111111111111111111111111111111111111111111111111111
1111111111111111111111111111111111111111111111111111111111111111111111111111111111111111111111111111111111111111
