

  NO		./assets/north.xpm
SO ./assets/south.xpm
F 139,69,19

  WE	./assets/west.xpm

EA ./assets/east.xpm

C		 30,144,255
  DO	./assets/door.xpm
  XO	./assets/sprite.xpm





1111111111111111111111111111111111111111111111111111111111111111111111
1000000000000000000000000000000000000000000000000000000000000000000001
1000111111111110001000000000000000000000000000000000000000000000000001
10001         10000000000000000000000000000000000000000000000000000001
1000111   111110000000000000000000000000000000000000000000000000000001
10000001 1000000000000000000000000000000000000000000000000000000000001
1000000010000000000000000000000000000000000000000000000000000000000001
1000000000000000000000000000000000000000000000000000000000000000000001
1000000000000000000000000000000000000000000000000000000000000000000001
10000000E0000000000000000000000000000000000000000000000000000000000001
1000000000000000000000000000000000000000000010000000000000000000000001
1000000000000000000000000000000000000000000000000000000000000000000001
1000000000000000000000000000000000000000000000000000000000000000000001
1000000000000000000000000000000000000000000000000000000000000000000001
1000000000000000000000000000000000000000000000000000000000000000000001
1111111111111111111111111111111111111111111111111111111111111111111111
