														F 									               153				, 204  	,			255				   					
		    			
					
							
				WE ./assets/green.xpm
									EA ./assets/blue.xpm


			NO ./assets/red.xpm
	 																											                  SO ./assets/grey.xpm



			C 				128			,	128	,																									128
		
		
		
		
   
   
111111111111                           11111111111111111 
10000000011                            10000000000000001
101100000111                           11100001100000101
100100000001                           10100000110000101
100000000001                           10000000000W00001
111111111111                           11111111111111111
