SO ./assets/carpet.xpm
EA ./assets/carpet.xpm
WE ./assets/teacup.xpm
NO ./assets/brick.xpm
DO ./assets/door.xpm
XO ./assets/medpack.xpm

C 14,14,14
F 30,10,30

1111111111
100000D001
100E00s001
1000001111
1111111111
